C 252,0,255

F 166,200,6

       SO      ./pics/eagle.png
       NO     ./pics/redbrick.png
       WE     ./pics/greystone.png
       EA   ./pics/bluestone.png
	   
111111
1000S1
111111