111111111111111111111111111111111
100000001011000000000000000000001
101100001111000000000000000000001
100100000000000000000000000000001
111110111011000001110000000000001
100000001011000001110111111111101
111101111111110111000000100000001
111101111111110111010100100000001
110000001101010111000000100000001
100000001000000011000000000000001
1000000000000000110101001000000N1
110000011101010111111110111100011
111101111111010111011111110100011
111111111111111111111111111111111