C 252,1,255  
        
F 166,2,00000000001000000000000000000000000000000000000000033

    SO     ./pics/eagle.png
    NO     ./pics/redbrick.png
    WE     ./pics/greystone.png
    EA     ./pics/bluestone.png
	

111111
111111
1S001111
111111