
       SO     ./pics/mossy.png
       NO     ./pics/redbrick.png
       WE     ./pics/greystone.png
       EA     ./pics/bluestone.png


C 225,30,25
F 1,100,0

111111111111
111111111111
111111111111
100000100001
100S00010001
100000000001
111111111111
111111111111
111111111111