

C 77,67,67 
F 102,255,0      

       SO     ./pics/pillar.png f   
       NO     ./pics/redbrick.png   
       WE     ./pics/greystone.png   


       EA     ./pics/bluestone.png    

        1111111111111111111111111
        10000000000000000000000001
        10100110011110000000000001
        10010110100000000000000001
1111111110110110011110000000000001111111111111111111111111111111111111111111111111
10000000000000000000000000000000000000000000000000000000000000000000000000000000011
10000000000000000000000000000000000000000000000000000000000000000000000000000000011
10000000000000000000000000000000000000000000000000000000000000000000000000000000011
10000000000000000000000001000000000000000000000000000000000000000000000000000000011
10000000000000000000000000000000000000000000000000000000000000000000000000000000011
10000000000000000000000000000000000000000000000000000000000000000000000000000000011
10000000000000000000000000000000000000000000000000000000000000000000000000000000011
10000000000000000000000000000000000000000000000000000000000000000000000000000000011
100000000111110010011111100000000000000000000000000000000000000000000000000000000011
100000000111110010011111100000000000000000000000000000000000000000000000000000000011
100000000111110010011111100000000000000000000000000000000000000000000000000000000011
10000000000000000000000000000000000000000000000000000000000000000000000000000000011
10000000000000000000000000000000000000000000000000000000000000000000000000000000011
10000000000000000000000000000000000000000000000000000000000000000000000000000000011
1000000000000000000000000000000111111111111111111111111111111111111111111111111111
100000000000000000000000000000011
1111011111111110111000000100001
11111111111 1111111101111111101
                   101      101
                   101      101
                   101      101
                   101      101
                   101      101
                   101      101
                   101      101
1111111111111111111101      101
1000000000000000000001      101
1011111111111111111101      101
1000000000000000000001      101
1111111111111111111111      101
                            101
                            101
                            101
                            101
                            101
                            101
                            1N1
            111111111111111110111
            111111111111111110111
            1000000000000000000001
            10000000000001000000011
            100000000000001000000101
            111111111111111111111111