0111111111111111111111
1000000010110000000001
1011000S11110000000001
1001000000000000000001
1111101110110000000001
1000000010110000000001
1111011111111101000001
1111011111110101100011
1111111111111111111111